BasicView	BasicView:NibView:UIView:
FBDialog	FBDialog:UIView:
FBXMLHandler	FBXMLHandler:NSObject
NewsToonsAppDelegate	NewsToonsAppDelegate:NSObject
OAHMAC_SHA1SignatureProvider	OAHMAC_SHA1SignatureProvider:NSObject
SHKOfflineSharer	SHKOfflineSharer:NSOperation:
URLShortenerCredentials	URLShortenerCredentials:NSObject
SFHFKeychainUtils	SFHFKeychainUtils:NSObject
SHKPinboard	SHKPinboard:SHKSharer:UINavigationController:
OAAsynchronousDataFetcher	OAAsynchronousDataFetcher:NSObject
ToonLibrary	ToonLibrary:NSObject
SHKInstapaper	SHKInstapaper:SHKSharer:UINavigationController:
FBRequest	FBRequest:NSObject
SHKSharer	SHKSharer:UINavigationController:
FBSession	FBSession:NSObject
SHKCopy	SHKCopy:SHKSharer:UINavigationController:
SHKSafari	SHKSafari:SHKSharer:UINavigationController:
SHKActivityIndicator	SHKActivityIndicator:UIView:
OAPlaintextSignatureProvider	OAPlaintextSignatureProvider:NSObject
InfoViewController	InfoViewController:BasicViewController:UIViewController:
ToonDisplayView	ToonDisplayView:BasicView:NibView:UIView:
SHKFacebook	SHKFacebook:SHKSharer:UINavigationController:
OAConsumer	OAConsumer:NSObject
SHKReadItLater	SHKReadItLater:SHKSharer:UINavigationController:
SHKGoogleReader	SHKGoogleReader:SHKSharer:UINavigationController:
FBPermissionDialog	FBPermissionDialog:FBLoginDialog:FBDialog:UIView:
SHKCustomShareMenuCell	SHKCustomShareMenuCell:UITableViewCell:
SHKFormController	SHKFormController:UITableViewController:
CategoryView	CategoryView:UIView:
FBLoginButton	FBLoginButton:UIControl:
SHKShareMenu	SHKShareMenu:UITableViewController:
BasicViewController	BasicViewController:UIViewController:
OARequestParameter	OARequestParameter:NSObject
SHKCustomShareMenu	SHKCustomShareMenu:SHKShareMenu:UITableViewController:
OAToken	OAToken:NSObject
SagaViewController	SagaViewController:BasicViewController:UIViewController:
InformationView	InformationView:NibView:UIView:
OAServiceTicket	OAServiceTicket:NSObject
OADataFetcher	OADataFetcher:NSObject
SearchViewController	SearchViewController:UIViewController:
SHK	SHK:NSObject
SHKOAuthSharer	SHKOAuthSharer:SHKSharer:UINavigationController:
NibView	NibView:UIView:
YouTubeView	YouTubeView:UIView:
SmallDisplayView	SmallDisplayView:BasicView:NibView:UIView:
FBLoginDialog	FBLoginDialog:FBDialog:UIView:
FBFeedDialog	FBFeedDialog:FBDialog:UIView:
SHKViewControllerWrapper	SHKViewControllerWrapper:UIViewController:
ParseOperation	ParseOperation:NSOperation:
SagaToonView	SagaToonView:UIView:
DesktopViewController	DesktopViewController:BasicViewController:UIViewController:
Constants	Constants:NSObject
Model	Model:NSObject
DesktopCell	DesktopCell:BasicView:NibView:UIView:
ToonViewController	ToonViewController:UIViewController:
SplashView	SplashView:UIView:
SHKOAuthView	SHKOAuthView:UIViewController:
SHKTumblr	SHKTumblr:SHKSharer:UINavigationController:
FBStreamDialog	FBStreamDialog:FBDialog:UIView:
SHKTwitterForm	SHKTwitterForm:UIViewController:
URLShortener	URLShortener:NSObject
SHKPhotoAlbum	SHKPhotoAlbum:SHKSharer:UINavigationController:
SHKFBStreamDialog	SHKFBStreamDialog:FBStreamDialog:FBDialog:UIView:
SHKFormFieldCell	SHKFormFieldCell:UITableViewCell:
TestFlight	TestFlight:NSObject
FavoriteViewController	FavoriteViewController:BasicViewController:UIViewController:
OAMutableURLRequest	OAMutableURLRequest:NSMutableURLRequest
SHKTwitter	SHKTwitter:SHKOAuthSharer:SHKSharer:UINavigationController:
SHKActionSheet	SHKActionSheet:UIActionSheet:
SHKDelicious	SHKDelicious:SHKOAuthSharer:SHKSharer:UINavigationController:
SHKCustomFormFieldCell	SHKCustomFormFieldCell:SHKFormFieldCell:UITableViewCell:
FaveTwitterController	FaveTwitterController:FavoriteViewController:BasicViewController:UIViewController:
SHKMail	SHKMail:SHKSharer:UINavigationController:
ToonTableCell	ToonTableCell:UITableViewCell:
ToonDisplayViewController	ToonDisplayViewController:FaveTwitterController:FavoriteViewController:BasicViewController:UIViewController:
Toon	Toon:NSObject
SHKFormFieldSettings	SHKFormFieldSettings:NSObject
SHKItem	SHKItem:NSObject
SHKCustomFormController	SHKCustomFormController:SHKFormController:UITableViewController:
SHKRequest	SHKRequest:NSObject
HomeViewController	HomeViewController:FaveTwitterController:FavoriteViewController:BasicViewController:UIViewController:
Reachability	Reachability:NSObject